111111111
1E00C1111
111100111
1T00C1C01
1P00P0C01
111111111
