111111111
1C01000C1
1T0001101
1P0011E01
111111111
