1111111111111111111
1T0001111E0C000C001
1C01000011111111101
11110T00T0C0T0C0T01
1P000TC000T0C0T0001
1111111111111111111
