111111111
1E00C1111
1111j0111
1000C1C01
1P0000C01
111111111
