111111111
1E00C1111
111100111
1000C1C00
1P0000C01
111111111
