111111111
1E00C1111
111100111
1000C1C01
1P0000C01
11111111
